            "        ###########    ##r##    ###########       ",
            "        ##       ##    ##@##    ##       ##       ",
            "        ##   i   ##    ## ##    ##   i   ##       ",
            "        ##       ######## ########       ##       ",
            "        ##                               ##       ",
            "        ##                               ##       ",
            "        ##               *               ##       ",
            "        ##                               ##       ",
            "        ##                               ##       ",
            "        ##                               ##       ",
            "        ##          *         *          ##       ",
            "        ##                               ##       ",
            "        ##                               ##       ",
            "        ###################################       ",             
            "                                                  "
