            "                                     ",
            "                                     ",
            "            #################        ",
            "          ####             ##        ",
            "        ####         *     ##        ",
            "        ##                 ##        ",
            "        ##                 ##########",
            "        ##    i                   @w#",
            "        ##                 ##########",
            "        ##                 ##        ",
            "        ####         *     ##        ",
            "          ####             ##        ",
            "            #################        ",
            "                                     ",
            "                                     ",
