            "        ###########    #####    ###########       ",
            "        ##       ##    ##w##    ##       ##       ",
            "        ##   i   ##    ##@##    ##   i   ##       ",
            "        ##       ######## ########       ##       ",
            "        ##                               ##       ",
            "        ##                               ##       ",
            "        ##               *               ##       ",
            "        ##                               ##       ",
            "        ##                               ##       ",
            "        ##                               ##       ",
            "        ##          *         *          ##       ",
            "        ##                               ##       ",
            "        ##                               ##       ",
            "        ###################################       ",             
            "                                                  ",
