            "                                     ",
            "                                     ",
            "            #################        ",
            "          ####             ##        ",
            "        ####         *     ##        ",
            "        ##                 ##        ",
            "        ##                 ##        ",
            "        ##    i           @w#        ",
            "        ##                 ##        ",
            "        ##                 ##        ",
            "        ####         *     ##        ",
            "          ####             ##        ",
            "            #################        ",
            "                                     ",
            "                                     "
