            "                                    ",
            "                                    ",
            "                                    ",
            "             ###############        ",
            "             ##           ##        ",   
            "             ##     i     ##        ",
            "###############           ##        ",
            "r @                 i     ##        ",
            "###############           ##        ",
            "             ##     i     ##        ",
            "             ##           ##        ",
            "             ###############        ",
            "                                    ",
            "                                    ",
            "                                    ",
