            "                                     ",
            "                                     ",
            "                                     ",
            "             ################        ",
            "             ##            ##        ",   
            "             ##   i    i   ##        ",
            "###############            ##        ",
            "#w@               i    i   ##        ",
            "###############            ##        ",
            "             ##   i    i   ##        ",
            "             ##            ##        ",
            "             ################        ",
            "                                     ",
            "                                     ",
            "                                     ",
